版本[版本]	ban3ben3	noun edition (as in different forms, bindings, etc. or by different publishers) 发行新版本 fāxíng xīn bǎnběn issue a fresh edition 这本书有三个版本。 Zhè běn shū yǒu sān ge bǎnběn. This book has three editions.
油条[油條]	you2tiao2	1 youtiao (deep-fried breadstick) M: 根gēn [根] 2 slick and sly person
脱裤子放屁[脫褲子放屁]	tuo1ku4zi5fang4pi4	1 lit. to take off trousers to fart 2 fig. to do something absolutely unnecessary 3 fig. to make things too complicated
炸酱面[炸醬麵]	zha2jiang4mian4	noodles served with fried bean sauce
西[西]	Xi1	1 the West 2 abbr. for Spain 西班牙Xībānyá [西班牙] 3 Spanish
谭仔[譚仔]	tan2 zi3	Tan Chai, name of a restaurant in Hong Kong
尽头[盡頭]	jin4tou2	noun end 路的尽头 lù de jìntóu the end of the road 学问是没有尽头的。 Xuéwen shì méiyǒu jìntóu de. There is no limit to knowledge.
目录[目錄]	mu4lu4	noun 1 catalogue; list 图书目录 túshū mùlù library catalogue 出口商品目录 chūkǒu shāngpǐn mùlù catalogue of export commodities; export list 2 table of contents; contents 3 computing directory
以来[以來]	yi3lai2	noun (of time) since 长期以来 chángqīyǐlái for a long time past 新中国建国以来 Xīn Zhōngguó jiànguó yǐlái since the founding of the People’s Republic of China 三年以来 sān nián yǐlái in the past three years 自古以来 zìgǔ yǐlái ever since the ancient times
对于[對於]	dui4yu2	preposition with regard to; concerning; to 对于具体问题要具体分析。 duìyú jùtǐ wèntí yào jùtǐ fēnxi. We should make a concrete analysis of each specific question. 对于他的工作我没有意见。 duìyú tā de gōngzuò wǒ méiyǒu yìjian. I have no complaints regarding his work. 她对于你的建议有什么反应？ Tā duì yú nǐ de jiànyì yǒu shénme fǎnyìng？ How did she react to your suggestion? 我对于音乐没有鉴赏力。 Wǒ duìyú yīnyuè méiyǒu jiànshǎnglì. I have no ear for music.
佢[佢]	qu2	pronoun dialect he or she
弹簧[彈簧]	tan2huang2	noun (metal) spring 保险弹簧 bǎoxiǎn tánhuáng relief spring 回动弹簧 huí dòng tánhuáng return spring
火柴[火柴]	huo3chai2	noun match 划根火柴 huá gēn huǒchái strike a match
闻所未闻[聞所未聞]	wen2suo3wei4wen2	idiom hear what one has never heard before; unheard-of 他们给我讲了很多闻所未闻的事情。 Tāmen gěi wǒ jiǎng le hěn duō wénsuǒwèiwén de shìqing. They told me a lot of things I had never heard before.
堵[堵]	du3	verb stop up; block up 把老鼠洞堵死 bǎ lǎoshǔ dòng dǔ sǐ stop up mouseholes 别堵着门！ Bié dǔ zhe mén! Don’t stand in the doorway! 我鼻子堵了。 Wǒ bízi dǔ le. My nose is all blocked up.  adjective stifled; suffocated; oppressed 胸口堵得慌 Xiōngkǒu dǔ de huāng suffocated; feel a tightness in the chest 心里堵得难受 xīnli dǔ de nánshòu have a load on one’s mind; feel oppressed  noun archaic wall 观者如堵。 Guānzhěrúdǔ. There was a crowd of spectators.  measure word [of walls] 一堵墙 Yī dǔ qiáng a wall
犹太[猶太]	You2tai4	noun Judah (an ancient kingdom)
灵感[靈感]	ling2gan3	noun inspiration (for creative work) 他的灵感来源于大自然。 Tā delínggǎn láiyuányú dàzìrán. He draws his inspiration from nature.
喷涌[噴湧]	pen1yong3	verb gush; spout
纸上谈兵[紙上談兵]	zhi3shang4-tan2bing1	idiom fight only on paper; an armchair strategist; idle theorizing; all talk and no action; impractical
家破人亡[家破人亡]	jia1po4-ren2wang2	idiom With one's family broken up, its members died or are scattered 如果不是解放, 我早已家破人亡了。 Rúguǒ bù shì jiěfàng, wǒ zǎoyǐ jiāpòrénwáng le. If it were not for the liberation, my whole family would have been ruined.
绷[繃]	beng1	verb 1 stretch (or draw) tight 在绷子上绷块绸子 Zài bēngzi shàng bēng kuài chóuzi stretch a piece of silk on an embroidery frame 弓弦一定要绷紧。 Gōng xián yīdìng yào bēng jǐn. The bowstring must be drawn tight. 别把自己的弦绷得太紧。 bié bǎ zìjǐ de xián bēng de tài jǐn. Don’t overstress yourself. 2 spring; bounce 盒子一打开, 弹簧就绷了出来。 Hézi yī dǎkāi, tánhuáng jiù bēng le chūlai. When the box was opened, the spring jumped out. 3 baste; tack; pin 绷着金字的横幅红布 Bēng zhe jīn zì de héngfú hóng bù a red cloth banner with gold paper characters pinned on it 把衣服折边绷起来 bǎ yīfu zhé biān bēng qǐlai baste a hem 4 dialect manage to do sth. with difficulty 绷场面 bēng chǎngmiàn keep up appearances 他绷不了多久了。 tā bēng bùliǎo duō jiǔ le. He can’t go on like this for long. or His days are numbered.  noun 1 bed frame strung with ropes, strips of rattan, etc. 2 VARIANT OF 17430784绷子beng1zi5绷子1 embroidery frame; hoop; tambour  verb dialect swindle; cheat out of money 坑绷拐骗 kēng bēng guǎipiàn resort to all sorts of deception; use all underhand means
蚌[蚌]	bang4	noun freshwater mussel; clam
余生[餘生]	yu2sheng1	noun 1 remainder of one's life; one's remaining years 安度余生 āndù yúshēng live out one’s days 2 survival (after a disaster) 劫后余生 jiéhòuyúshēng survive a disaster (or war)
山楂[山楂]	shan1zha1	noun (Chinese) hawthorn (Crataegus pinnatifida Bge); may (thorn); maybush; haw
苍穹[蒼穹]	cang1qiong2	noun literary vault of heaven; firmament
无穷[無窮]	wu2qiong2	verb infinite; endless; boundless; inexhaustible 无穷的烦恼和忧虑 Wúqióng de fánnǎo hé yōulǜ endless troubles and worries
从容[從容]	cong2rong2	adjective 1 calm; unhurried; leisurely 从容就义 cóngróng-jiùyì go to one’s death unflinchingly; meet one’s death like a hero 举止从容 jǔzhǐ cóngróng deport oneself in a calm, unhurried manner 2 plentiful 手头从容 Shǒutóu cóngróng be quite well off at the moment 时间很从容。 Shíjiān hěn cóngróng. There’s still plenty of time.
大悲咒[大悲咒]	Da4bei1zhou4	the Great Compassion Mantra
顺[順]	shun4	verb 1 arrange; put in order 这篇文章还得顺一顺。 Zhè piān wénzhāng hái děi shùn yī shùn. This essay needs polishing. 把这些讲义顺一顺, 不要放得乱七八糟的。 Bǎ zhèxiē jiǎngyì shùn yī shùn, bù yào fàng de luànqībāzāo de. Please put these lecture notes in order and don’t leave them in a mess. 2 obey; yield to; act in submission to (opp. 逆) 他不对嘛, 怎么能顺着他呢？ Tā bù duì ma, zěnme néng shùnzhe tā ne？ How can we do as he wishes when he’s obviously wrong? 3 fall in with; suit; agree with; follow See 74516906顺意shun4yi4顺意 4 [at the close of a letter] take the opportunity to 顺颂大安。 Shùn sòng dà'ān. With best wishes for your health. 顺致最崇高的敬意。 Shùn zhì zuì chónggāo de jìngyì. I avail myself of this opportunity to renew to you the assurances of my highest consideration. 5 in sequence See 30710528顺延shun4yan2顺延  adjective 1 (of writings) smooth; readable; clear and well-written 2 favourable; smooth; successful 他今年不太顺。 Tā jīnnián bùtài shùn. He’s been out of luck this year.  preposition 1 in the same direction as; with 顺风而行 shùn fēng ér xíng sail with the wind 2 along 顺着这条道儿走。 Shùnzhe zhè tiáo dàor zǒu. Follow this road. 水顺着渠道流进地里。 Shuǐ shùnzhe qúdào liú jìn dì lǐ. Water runs along the channel to the fields. 3 at one's convenience; conveniently See 74515882顺手儿shun4shou3r5顺手儿
无病呻吟[無病呻吟]	wu2bing4-shen1yin2	idiom 1 moan and groan without being ill—make a fuss about an imaginary illness; complain without any reason 2 artificial; affected (writing or speech)
水晶球[水晶球]	shui3jing1qiu2	crystal ball
霸王鸡[霸王雞]	ba4 wang2 ji1	to use the service of a prostitute without paying [colloquial]
环[環]	huan2	noun 1 ring; hoop 在窗帘上缝几个环儿 Zài chuānglián shàng féng jǐ ge huánr. sew some rings on the curtain 2 link 一环套一环 Yī huán tào yī huán linked together; wheels within wheels 最薄弱的一环 zuì bóruò de yī huán the weakest link 3 sports ring 命中九环 mìngzhòng jiǔ huán hit the nine-point ring 在射箭中取得三百四十二环的成绩 zài shèjiàn zhōng qǔdé sānbǎi sìshí'èr huán de chéngjì score 342 points in archery  verb surround; encircle; hem in 环滁皆山也。(欧阳修《醉翁亭记》) huán Chú jiē shān yě. Chuzhou is surrounded by mountains.
卡尺[卡尺]	ka3chi3	noun abbreviation vernier calliper
屎[屎]	shi3	noun 1 excrement; faeces; stool; dung; droppings 屎坑 shǐkēng dung pit; manure pit 鸡屎 jī shǐ chicken droppings 牛屎 niú shǐ cow dung 2 secretion (of the eye, ear, etc.) 耳屎 ěrshǐ earwax
橡皮[橡皮]	xiang4pi2	noun 1 (vulcanized) rubber 橡皮手套 xiàngpí shǒutào rubber (operating) gloves 2 eraser; rubber
残忍[殘忍]	can2ren3	adjective cruel; ruthless 他这样对待老年人, 太残忍了。 Tā zhèyàng duìdài lǎoniánrén, tài cánrěn le. It’s really cruel of him to treat old people like that.
共产党[共產黨]	gong4chan3dang3	noun Communist Party
格子呢[格子呢]	ge2zi5ni2	1 tartan 2 plaid
抛物线轨迹[拋物線軌跡]	pao1wu4xian4 gui3ji4	parabolic path; parabolic trajectory
线[線]	xian4	1 thread 2 string 3 wire 4 line M: 条tiáo [条] / 股gǔ [股] / 根gēn [根] 5 (after a number) tier (unofficial ranking of a Chinese city)
沉鱼落雁[沉魚落雁]	chen2yu2luo4yan4	lit. fish sink, goose alights (idiom, from Zhuangzi 庄子Zhuāngzǐ [庄子]); fig. female beauty captivating even the birds and beasts
闭月羞花[閉月羞花]	bi4yue4xiu1hua1	1 lit. hiding the moon, shaming the flowers (idiom) 2 fig. female beauty exceeding even that of the natural world
背水一战[背水一戰]	bei4shui3yi1zhan4	lit. fight with one's back to the river (idiom); fig. to fight to win or die
摊子[攤子]	tan1zi5	1 booth; vendor's stall 2 (fig.) organizational structure; scale of operations
心虚[心虛]	xin1xu1	1 lacking in confidence 2 diffident 3 to have a guilty conscience
生猛[生猛]	sheng1meng3	1 full of life 2 violent 3 brave 4 fresh (of seafood)
阴茎[陰莖]	yin1jing1	noun anatomy penis; phallus
整容[整容]	zheng3//rong2	verb 1 tidy oneself up (i.e. have a haircut, a shave, etc.) 2 face-lift
关上[關上]	guan1shang4	1 to close (a door) 2 to turn off (light, electrical equipment etc)
讲述[講述]	jiang3shu4	to talk about; to narrate; to give an account
脊椎[脊椎]	ji3zhui1	1 vertebra 2 backbone
哺乳动物[哺乳動物]	bu3ru3dong4wu4	mammal
撑[撐]	cheng1	1 to support 2 to prop up 3 to push or move with a pole 4 to maintain 5 to open or unfurl 6 to fill to bursting point 7 brace 8 stay 9 support
酒后吐真言[酒後吐真言]	jiu3hou4 tu3 zhen1yan2	idiom wine in, truth out
独特[獨特]	du2te4	unique; distinctive
调皮[調皮]	tiao2pi2	adjective 1 naughty; mischievous; cheeky 调皮捣蛋 tiáopí-dǎodàn mischievous; troublesome; make trouble 调皮的孩子 tiáopí de háizi a naughty child 2 unruly; disobedient 调皮的牲口 tiáopí de shēngkou skittish beast 3 tricky; smart-alecky
轮椅[輪椅]	lun2yi3	noun wheelchair 机动轮椅 jīdòng lúnyǐ motorized wheelchair
获[獲]	huo4	verb 1 capture; catch 捕获 bǔhuò capture; seize 2 obtain; win; reap 获一等奖 huò yīděng jiǎng win the first prize
慈祥[慈祥]	ci2xiang2	1 kindly 2 benevolent (often of older person)
鞠[鞠]	ju1	verb literary rear; bring up 鞠育 jūyù rear; bring up  noun 1 (Jū) a surname 2 bow See 24589568鞠躬ju1gong1鞠躬  verb archaic ball used for play 蹴鞠 cù jū kick a ball
将[將]	jiang1	1 will 2 shall 3 to use 4 to take 5 to checkmate 6 just a short while ago 7 (introduces object of main verb, used in the same way as 把bǎ [把])
珊瑚[珊瑚]	shan1hu2	coral
开审[開審]	kai1//shen3	verb start the trial; sit at session; be in session
韬光养晦[韜光養晦]	tao1guang1-yang3hui4	idiom hide one's capacities and bide one's time
寂寞[寂寞]	ji4mo4	adjective 1 lonely; lonesome 我在这里又交了新朋友, 一点也不寂寞。 Wǒ zài zhèlǐ yòu jiāo le xīn péngyou, yīdiǎn yě bù jìmò. I don’t feel lonely as I’ve made new friends here. 2 quiet; still; silent 寂寞的原野 Jìmò de yuányě quiet open country
勇气[勇氣]	yong3qi4	noun courage; nerve 鼓起勇气 gǔqǐ yǒngqì pluck up (or muster up) one’s courage
在岗[在崗]	zai4gang3	verb be at one's post; employed
福音[福音]	fu2yin1	noun 1 glad tidings 2 religion Christianity Gospel
这样[這樣]	zhe4yang4	pronoun so; such; like this; this way 一会儿这样, 一会儿那样 Yīhuìr zhèyàng, yīhuìr nàyàng now one way, now another 别走这样快。 Bié zǒu zhèyàng kuài. Don’t walk so fast. 竟有这样的事？ Jìng yǒu zhèyàng de shì? How could such a thing happen? or Is this possible? 情况就是这样。 Qíngkuàng jiù shì zhèyàng. That’s how it is. or That’s the situation. 他怎么病成这样了？ Tā zěnme bìng chéng zhèyàng le？ How did he get so ill? or How did he get into such a state? 这样的文学作品很受群众欢迎。 Zhèyàng de wénxué zuòpǐn hěn shòu qúnzhòng huānyíng. Literary works of this kind are very popular. 如果你们觉得可以这样办, 那就这样办吧。 Rúguǒ nǐmen juéde kěyǐ zhèyàng bàn, nàjiù zhèyàng bàn ba. If you people feel this is the right thing to do, then do it.
灌[灌]	guan4	1 slam dunk 2 to feed forcefully
进[進]	jin4	(verb) Get in or into; (adjective) advanced
系[繫]	xi4	1 to connect 2 to arrest 3 to worry 4 to connect 5 to relate to 6 to depend on 7 to be concerned 8 to bind to 9 to fasten 10 to knot 11 to buton up
太阳系[太陽系]	tai4yang2xi4	solar system
木星[木星]	mu4xing1	noun Jupiter
确[確]	que4	1 authenticated 2 solid 3 firm 4 real 5 true 6 sure 7 certain 8 secure 9 valid
确保[確保]	que4bao3	verb ensure; guarantee 确保质量 Quèbǎo zhìliàng guarantee quality 确保安全生产 Quèbǎo ānquán shēngchǎn ensure safety in production 确保不发生类似事件 Quèbǎo bù fāshēng lèisì shìjiàn ensure against the occurrence of similar incidents 要确保适时播种。 Yào quèbǎo shìshí bōzhǒng. Be sure to do the sowing in good time.
所有人[所有人]	suo3 you3 ren2	noun; all of the people, everyone, everybody
海王星[海王星]	hai3wang2xing1	noun astronomy Neptune
冥[冥]	ming2	1 dark 2 deep 3 stupid 4 the underworld 5 night 6 a surname 7 deep 8 dim
冥王星[冥王星]	ming2wang2xing1	noun astronomy Pluto
不过[不過]	bu4guo4	adverb 1 [as an intensifier after an adjective] 那就再好不过了！ Nà jiù zài hǎo bù guò le! It couldn’t be better! or That would be superb! 2 only; merely; no more than 她上大学的时候不过(才)17岁。 tā shàng dàxué de shíhoubùguò17 suì. She was only 17 when she entered college.  conjunction but; however; only 病人精神还不错, 不过胃口不大好。 Bìngrén jīngshén hái bùcuò, bùguò wèikǒu bùdà hǎo. The patient feels pretty good, but hasn’t much of an appetite.
地质[地質]	di4 zhi4	geological
井底之蛙[井底之蛙]	jing3di3zhi1wa1	idiom a frog in a well—a person with a very limited outlook; ignorant; narrow-minded See 24433152井蛙jing3wa1井蛙
银河系[銀河系]	Yin2he2xi4	astronomy Milky Way system; Galaxy
恐水病[恐水病]	kong3shui3bing4	noun medicine hydrophobia; rabies; canine madness
终止[終止]	zhong1zhi3	verb 1 stop; end 终止日期 zhōngzhǐ rìqī closing date; deadline 要求终止这种不正常状态 Yāoqiú zhōngzhǐ zhèzhǒng bù zhèngcháng zhuàngtài request an end to this abnormal state of affairs 2 terminate; annul; abrogate; expire 终止条约通知书 zhōngzhǐ tiáoyuē tōngzhīshū notice of termination of a treaty; notice of denunciation  noun music cadence
公升[公升]	gong1sheng1	measure word litre (l)
这[這]	zhe4	pronoun 1 this 这地方 zhè dìfang this place 这一回 zhè yī huí this time 这就对了。 Zhè jiù duì le. Now you’re on the right track. or Now that’s better. 这是新产品。 zhè shì xīnchǎnpǐn. These are new products. 这究竟是怎么回事？ Zhè jiūjìng shì zěnme huí shì？ What’s all this about? 这才是好孩子！ Zhè cái shì hǎo háizi! That’s a good boy (girl)! or That’s a dear! 这消息我知道了。 Zhè xiāoxi wǒ zhīdao le. I’ve heard that news already. or Yes, so I’ve heard. 2 now 我这就走。 Wǒ zhè jiù zǒu. I’m leaving right now. 他这才知道锻炼身体的好处。 Tā zhè cái zhīdao duànliàn shēntǐ de hǎochu. Only now does he see the benefit of exercise.
声[聲]	sheng1	noun 1 sound; noise; phono; voice 声如洪钟 shēngrúhóngzhōng sb.’s voice is like a great bell 高声朗读 gāoshēng lǎngdú read aloud 喊杀声 hǎn “shā” shēng battle cry 脚步声 jiǎobùshēng sound of footsteps 小声儿说话 xiǎo shēng r shuōhuà speak in a low voice 2 initial of a Chinese syllable See 29899776声母sheng1mu3声母 3 tone 去声 qùshēng falling tone 4 reputation See 29907968声誉sheng1yu4声誉  verb make a sound 不声不响 bùshēngbùxiǎng quiet; silent  measure word [for sounds] 我喊了他两声。 Wǒ hǎn le tā liǎng shēng. I called to him twice. 我听见一声炮响。 Wǒ tīng jiàn yī shēng pào xiǎng. I heard the sound of a cannon going off.
飞[飛]	fei1	verb 1 (of birds or insects) fly; flit 飞鸟 fēiniǎo flying bird 老鹰飞得高。 Lǎoyīng fēi de gāo. Eagles fly high. 小鸟飞(走)了。 Xiǎoniǎo fēi le. The bird flew away. 蜜蜂在花丛中飞来飞去。 Mìfēng zài huā cóng zhōng fēi lái fēi qù. Bees are flitting from flower to flower. 2 (of an aircraft or its occupants) fly; travel by plane 我明天飞上海。 Wǒ míngtiān fēi Shànghǎi. I’m flying to Shanghai tomorrow. 那架飞机从北京直飞广州。 Nà jià fēijī cóng Běijīng zhí fēi Guǎngzhōu. That plane flies nonstop from Beijing to Guangzhou. 3 hover or flutter in the air 飞絮 fēi xù willow catkins fluttering in the air 飞鸢 Fēi yuān a hovering kite 飞雪花了。 Fēi xuě huā le. It’s snowing. 4 colloquial disappear through volatilization 樟脑丸放久了会飞净的。 Zhāngnǎowán fàng jiǔ le huì fēi jìng de. Camphor balls will disappear as time goes on.  adverb (move) swiftly See 20860928飞奔fei1ben1飞奔  adjective unexpected; accidental; unfounded; groundless 飞祸 fēihuò unexpected disaster See 26086144流言飞语liu2yan2fei1yu3流言飞语  noun dialect free wheel (of a bicycle)
听[聽]	ting1	verb 1 listen; hear 听广播 Tīng guǎngbō listen to the radio 听, 好像有人敲门。 tīng, hǎoxiàng yǒurén qiāo mén. Listen, it sounds like someone knocking at the door. 听声音不像他。 Tīng shēngyīn bù xiàng tā. The voice didn’t sound like him. 请听我说完。 Qǐng tīng wǒ shuō wán. Please hear me out. 请听一下电话。 Qǐng tīng yī xià diànhuà. Answer the phone, please. 厂长要你听电话。 Chǎngzhǎng yào nǐ tīng diànhuà. The director wants you on the phone. 打开收音机听听新闻。 Dǎkāi shōuyīnjī tīngtīng xīnwén. Turn on the radio and listen to the news. 到群众中走一走, 听听他们的意见。 Dào qúnzhòng zhōng zǒu yī zǒu, tīngtīng tāmen de yìjian. Go among the people and hear what they have to say. 你听着, 我在给你讲呢！ Nǐ tīng zhe, wǒ zài gěi nǐ jiǎng ne! Listen to me, I’m talking to you! 他的话听起来不诚恳。 Tā de huà tīng qǐlai bù chéngkěn. He did not sound sincere. or His words rang hollow. 他的四川口音我听不出来。 Tā de Sìchuān kǒuyin wǒ tīng bù chūlai. I can’t detect his Sichuan accent. 他唆了半天, 我实在听不下去了。 Tā suō le bàntiān, wǒ shízài tīng bùxià qùle. He rambled on for hours and I could stand it no longer. 我没听过这样好的音乐。 Wǒ méi tīng guò zhèyàng hǎo de yīnyuè. I’ve never heard such beautiful music before. 这一句我没听清。 Zhè yī jù wǒ méi tīng qīng. I didn’t quite catch that sentence. 这些话听起来倒也有些道理。 Zhèxiē huà tīng qǐlai dào yě yǒuxiē dàoli. That actually sounds quite reasonable. 2 heed; obey; listen to 对批评听不进去 Duì pīpíng tīng bù jìnqu turn a deaf ear to criticism 听我的没错儿。 Tīng wǒ de méicuòr. Do as I say and you won’t go wrong. 我劝他别去, 他不听。 Wǒ quàn tā bié qù, tā bù tīng. I advised him not to go, but he wouldn’t listen. 家里的事我都听她的。 Jiālǐ de shì wǒ dōu tīng tā de. When it comes to household matters, I listen to her. 工地上一切都听他指挥。 Gōngdì shàng yīqiè dōu tīng tā zhǐhuī. Everything on the construction site is under his command. 老了, 胳膊腿儿不听使唤了。 Lǎo le, gēbo tuǐr bù tīng shǐhuan le. I’m getting old. My limbs don’t obey me anymore 她要听了我的话, 哪会有今天。 Tā yào tīng le wǒ dehuà, nǎ huì yǒu jīntiān. If she’d heeded me, things would be different today. 3 administer; manage 听政 tīngzhèng conduct a hearing; hold count  verb allow; let 听由老板摆布 tīng yóu lǎobǎn bǎibu be at the mercy of the boss  measure word transliteration tin; can 六听啤酒 liù tīng píjiǔ six cans of beer 三听咖啡 Sān tīng kāfēi three tins of coffee
发现[發現]	fa1xian4	verb 1 discover; find; detect; identify 发现一些线索 fāxiàn yīxiē xiànsuǒ find some clues 发现一个新方法 Fāxiàn yī ge xīn fāngfǎ discover a new method 2 find; realize; perceive; notice; be aware of 我发现他好像有什么心事。 Wǒ fāxiàn tā hǎoxiàng yǒu shénme xīnshi. I noticed that he seemed to have something on his mind. 我们发现他有精神病。 Wǒmenfāxiàn tā yǒu jīngshénbìng. We found him to have a mental disorder.  noun discovery; find 考古发现 kǎogǔ fāxiàn archaeological finds 物理学上一个划时代的发现 Wùlǐxué shàng yī ge huàshídài defāxiàn an epoch-making discovery in physics
岁[嵗]	sui4	noun 1 literary year 岁除 suìchú New Year’s Eve 岁杪 suìmiǎo end of the year; year-end 岁末 suìmò end of the year 岁时 suìshí four seasons 岁朝 suìzhāo first day of the lunar New Year 辞旧岁, 迎新年 cí jiù suì, yíng xīnnián ring out the old year and ring in the new 2 literary year's harvest 歉岁 qiànsuì lean year 3 age 同岁 tóngsuì of the same age 4 literary time 岁月如梭。 suì yuè rúsuō. How time flies.  measure word year (of age) 三岁女孩儿 sān suì nǚ hái'ér three-year-old girl
乱[亂]	luan4	noun 1 upheaval; riot; unrest; turmoil 内乱 nèiluàn civil strife 战乱 zhànluàn chaos caused by war; war 2 disorder; disturbance; trouble 添乱儿 Tiān luàn r add confusion to sth. 当断不断, 反受其乱。 dāngduànbùduàn, fǎn shòu qí luàn. Being indecisive will lead to troubles. 3 archaic literature last paragraph of a musical composition or genre of classical Chinese poetry  verb throw into disorder; confuse; mix up 乱了方寸 luàn le fāngcùn put one’s mind in turmoil; be greatly agitated 乱了手脚 luànleshǒujiǎo throw sb. into disarray 君其遗之女乐, 以乱其政。(《韩非子》) Jūn qí wèi zhī nǚ yuè, yǐ luàn qí zhèng. (《Hán Fēi Zǐ》) You might send him some women musicians to throw his rule into disorder.  adjective 1 in disorder; in a mess; in confusion 全乱了 quán luàn le be in a utter (or wild) confusion 线乱了。 Xiàn luàn le. The thread is tangled. 车站很乱。 Chēzhàn hěn luàn. The station was in a state of disorder. 屋里很乱, 请收拾一下。 wū lǐ hěn luàn, qǐng shōushi yīxià. The room is in a mess; please tidy it up. 这篇稿子太乱, 是不是重抄一下？ Zhè piān gǎozi tài luàn, shì bù shì zhòng chāo yīxià？ The manuscript’s too messy. How about copying it out? 这里太乱, 找个安静点儿的地方谈谈。 Zhèlǐ tài luàn, zhǎo ge ānjìng diǎnr de dìfang tán tán. It’s too noisy here; let’s find a quieter place to chat. 2 in a confused state of mind 我心里很乱。 Wǒ xīnli hěn luàn. My mind is in turmoil. 3 (of a society) turbulent; riotous See 26311424乱世luan4shi4乱世 4 (of sexual relationships) improper; promiscuous 性乱行为 Xìng luàn xíngwéi sexual promiscuity  adverb indiscriminately; at random; arbitrarily 乱跑 luànpǎo run all over the place; dash about 乱扔 luànrēng tumble over 乱罚款 luàn fákuǎn impose unjustified fines 乱花钱 luànhuāqián spend money extravagantly 乱收费 luàn shōufèi collect fees arbitrarily 乱出主意 luàn chū zhǔyi give advice offhand 乱穿马路 luànchuānmǎlù jaywalk 乱讲一气 luànjiǎng yī qì speak indiscreetly; make irresponsible remarks 乱作决定 luànzuòjuédìng make an arbitrary decision 他在墙上乱写。 Tā zài qiáng shàng luàn xiě. He scribbled on the wall. 各种木料乱堆在一起。 Gèzhǒng mùliào luàn duī zài yīqǐ. Logs and planks of all shapes and sizes were jumbled together.
聪[聰]	cong1	noun literary faculty of hearing 左耳失聪 zuǒ ěr shīcōng become deaf in the left ear  adjective 1 acute hearing See 20538368耳聪目明er3cong1mu4ming2耳聪目明 2 bright; smart; intelligent 聪睿 cōngruì wise and farsighted
朗[朗]	lang3	adjective 1 light; bright; clear 朗目疏眉 lǎng mù shū méi bright eyes and graceful eyebrows; with delicate features 2 loud and clear 开怀朗笑 Kāihuái lǎng xiào laugh heartily  noun (Lǎng) a surname
后空翻[後空翻]	hou4kong1fan1	noun sports backward somersault See 28332032前空翻qian2kong1fan1前空翻
胸部[胸部]	xiong1bu4	noun thorax; chest 袒露胸部 tǎnlù xiōngbù bare one’s breast 胸部手术 Xiōngbù shǒushù thoracic operation
袒露[袒露]	tan3lu4	verb expose (part of one's body) 袒露上身 tǎnlù shàngshēn be bare from the waist up
图解[圖解]	tu2jie3	noun 1 diagram; graph; figure 用图解说明 yòng tújiě shuōmíng explain through diagrams 2 illustration 3 mathematics graphic solution  verb explain with pictures, charts, etc.; illustrate
科技[科技]	ke1ji4	noun abbreviation science and technology 科技扶贫 kējì fúpín help a poverty-stricken area with science and technology 科技成果转让 kējì chéngguǒ zhuǎnràng transfer of scientific and technological achievements 科技创新能力 kējì chuàngxīn nénglì hi-tech innovation capacity 科技成果产业化 Kējì chéngguǒ chǎnyèhuà apply scientific and technological advances to production 科技是第一生产力。(邓小平) kējì shì dì-yī shēngchǎnlì. Science and technology is the first productive force.
运作[運作]	yun4zuo4	verb operate; work 影响经济运作 yǐngxiǎng jīngjì yùnzuò affect the performance of the economy
多工运作[多工運作]	duo1gong1yun4zuo4	multithreading
